111111111111111111111111111111111111111
111111111111111111111111111111111111111
100000000000000000000000000000000000001
100000000000000000000000000000000000001
100000000000000000000000000000000000001
101111100000000000000000000000000000001
100000100000000000000000000000000000001
100000100000000000000000000000000000001
100000000000000000000000000000000000001
100000000000000000000000000000000000001
100000000000000000000000000000000000001
100000000000000000000000000000000000001
100000000000000000000000000000000000001
102000000000000000000000000000000000001
100000000000000000000000000000000000001
100000000000000000000000000000000000001
100000100000000000000000000000000000001
101111100000000000000000000000000000001
100000000000000000000000000000000000001
100000000000000000000000000000000000001
100000000000000000000000000000000000001
111111111111111111111111111111111111111